Row,Col,Value,Region,Yellow
0,0,,1,0
0,1,,1,0
0,2,,1,0
0,3,,1,0
0,4,,1,0
0,5,,1,0
0,6,,1,0
0,7,,1,0
0,8,,1,0
0,9,,1,0
0,10,,1,0
1,0,,1,0
1,1,,2,0
1,2,,1,0
1,3,,1,1
1,4,,1,1
1,5,,1,0
1,6,,1,0
1,7,,1,0
1,8,,1,0
1,9,,1,0
1,10,,1,0
2,0,,2,0
2,1,,2,0
2,2,,3,0
2,3,,3,0
2,4,,3,1
2,5,,3,0
2,6,,4,0
2,7,,4,0
2,8,,4,0
2,9,,1,1
2,10,,4,0
3,0,,2,0
3,1,,3,0
3,2,,3,0
3,3,,2,0
3,4,,3,0
3,5,,5,0
3,6,,4,0
3,7,,4,0
3,8,,4,1
3,9,,4,1
3,10,,4,0
4,0,,2,0
4,1,,3,0
4,2,,3,0
4,3,,2,0
4,4,,3,0
4,5,,5,0
4,6,,5,0
4,7,,4,0
4,8,,4,0
4,9,,5,0
4,10,,4,0
5,0,,2,0
5,1,,2,0
5,2,,2,0
5,3,,2,0
5,4,,2,0
5,5,,5,1
5,6,,5,0
5,7,,5,0
5,8,,5,0
5,9,,5,0
5,10,,4,0
6,0,,2,0
6,1,,7,1
6,2,,6,1
6,3,,6,0
6,4,,2,0
6,5,,2,1
6,6,,5,1
6,7,,5,0
6,8,,6,0
6,9,,5,0
6,10,,5,0
7,0,,2,0
7,1,,7,1
7,2,,6,0
7,3,,6,0
7,4,,6,0
7,5,,6,1
7,6,,6,0
7,7,,6,0
7,8,,6,0
7,9,,8,0
7,10,,8,0
8,0,,7,0
8,1,,7,0
8,2,,7,0
8,3,,7,0
8,4,,6,1
8,5,,7,1
8,6,,6,0
8,7,,8,0
8,8,,8,0
8,9,,8,0
8,10,,8,0
9,0,,7,0
9,1,,7,0
9,2,,7,0
9,3,,7,0
9,4,,7,1
9,5,,7,0
9,6,,7,0
9,7,,7,0
9,8,,7,0
9,9,,7,0
9,10,,7,0
10,0,,7,0
10,1,,7,0
10,2,,9,0
10,3,,9,0
10,4,,9,0
10,5,,9,0
10,6,,9,0
10,7,,9,0
10,8,,7,0
10,9,,7,0
10,10,,7,0
